wcathery0	jscollick0@dot.gov
apraten1	pmucklo1@last.fm
cworsley2	wshirtcliffe2@blogs.com
imanchett3	cbailiss3@indiegogo.com
eguillon4	dhedan4@narod.ru
dpennycock5	tmann5@ebay.com
tservant6	mbrazer6@amazon.de
jtyrer7	sparkman7@baidu.com
mwiles8	rsiggin8@dailymotion.com
fvedyasov9	zcoath9@prlog.org
fcoatea	jdigwooda@themeforest.net
bcarnalanb	nsplevinb@wikimedia.org
ldansiec	hlowcockc@cisco.com
rnorhenyd	fvandaled@cocolog-nifty.com
lkeymee	catwoode@who.int
ktuckeyf	telfef@washington.edu
aricciog	clocarnog@reddit.com
djanaudh	mmelladewh@noaa.gov
fsinkingsi	sshadfourthi@instagram.com
hstygallj	wcardingj@nps.gov
scroyserk	ksemkinsk@instagram.com
wwestreyl	ihowlinl@ebay.com
mkuzemkam	mferrerim@webs.com
kdegreyn	obolithon@nbcnews.com
pbilovskyo	ctomasellio@sourceforge.net
wannwylp	mkorneichikp@shop-pro.jp
jpershouseq	nbartolomivisq@cyberchimps.com
apeatmanr	sdomenger@sbwire.com
wsturtons	cskainss@tinyurl.com
fdonovant	ehuglint@eepurl.com
goswicku	bjakobssenu@senate.gov
fleppingtonv	wplaisterv@dyndns.org
bwardropew	rgodbertw@smugmug.com
fkolodziejskix	kchristensenx@unblog.fr
vbreezey	bblethyny@ehow.com
droosez	pgrimmolbyz@examiner.com
kgresswell10	tstickens10@comsenz.com
mshallow11	dmackie11@ucsd.edu
emaplestone12	mwillimont12@huffingtonpost.com
fbickerdyke13	lklimkiewich13@hexun.com
vclemitt14	bsnoxall14@webs.com
pjaggar15	bcalterone15@netlog.com
tscreen16	nlillgard16@free.fr
rkilfether17	tfarrall17@sfgate.com
jtalby18	aextil18@ycombinator.com
asiney19	cgoodacre19@discuz.net
tcampanelle1a	sdobel1a@linkedin.com
blethbridge1b	bskitterel1b@state.tx.us
rderks1c	twittier1c@businessinsider.com
pheeron1d	mthornebarrow1d@mapquest.com
mdelcastel1e	tmacgiffin1e@phpbb.com
ebezley1f	clargent1f@rakuten.co.jp
lmacnockater1g	pbruce1g@about.com
bhalpeine1h	avarley1h@nhs.uk
bkobelt1i	tbrommage1i@webmd.com
jvardey1j	semmitt1j@bravesites.com
tlacoste1k	khughson1k@nifty.com
eeltun1l	biacobo1l@boston.com
unorrington1m	salderwick1m@geocities.jp
bpersse1n	dpalfrie1n@intel.com
kfantini1o	ggouldthorp1o@chronoengine.com
mianson1p	hwhyard1p@squarespace.com
nstoner1q	qrapi1q@ibm.com
mschuricht1r	coverbury1r@google.ru
bgerb1s	lmaghull1s@yahoo.co.jp
hpaulusch1t	mrottger1t@tinypic.com
mbraunlein1u	clentsch1u@yelp.com
kstoffers1v	cchurn1v@over-blog.com
bbridie1w	dmathelon1w@uol.com.br
cmitchenson1x	aboise1x@nydailynews.com
itresler1y	neastlake1y@scientificamerican.com
pmiskimmon1z	brevey1z@thetimes.co.uk
sbausmann20	ebronot20@whitehouse.gov
gtune21	tstaite21@nasa.gov
mbeggi22	ibizzey22@techcrunch.com
krobertis23	kpellissier23@mapy.cz
cloche24	shallowell24@free.fr
rdarrel25	smurrow25@globo.com
hdodworth26	lpammenter26@spotify.com
nhillin27	istookes27@last.fm
avicar28	levemy28@intel.com
rstembridge29	fbidnall29@hp.com
vdairton2a	chendonson2a@jigsy.com
rbasile2b	achoat2b@free.fr
ntweed2c	avonbrook2c@home.pl
ctwede2d	vcoulman2d@uol.com.br
dwikey2e	tslimon2e@admin.ch
dwolfarth2f	fvears2f@deviantart.com
stabner2g	kcotgrove2g@reuters.com
mhonnan2h	oriddler2h@usa.gov
jmancell2i	bmacgorley2i@wordpress.org
sdequesne2j	fcords2j@bravesites.com
jtree2k	anormansell2k@wufoo.com
gkneel2l	mlipson2l@usda.gov
pratcliffe2m	aburnage2m@fema.gov
lvasler2n	gboater2n@mapquest.com
sheinonen2o	mmattiazzo2o@cdc.gov
smyhan2p	fkaesmans2p@godaddy.com
jstracey2q	nzukerman2q@sun.com
hmcairt2r	sidale2r@taobao.com
ftolefree2s	rgranger2s@arstechnica.com
jwaddilove2t	mlockney2t@mashable.com
smantrip2u	mbredgeland2u@princeton.edu
amidden2v	lgriswood2v@wikimedia.org
gboshell2w	ycottom2w@squidoo.com
echipman2x	mtunkin2x@discovery.com
gvarnam2y	flamden2y@wikispaces.com
drannells2z	tdikles2z@mail.ru
pstroyan30	tnorree30@disqus.com
jpietruszka31	dvoice31@google.com
adreus32	daugie32@cbslocal.com
mbumby33	kbradnocke33@ovh.net
cfearneley34	disakowicz34@accuweather.com
dsellek35	mmatton35@mysql.com
bmurrthum36	bmerkle36@jimdo.com
cshakesby37	pakister37@disqus.com
ngillow38	eiskowitz38@lycos.com
tbrabben39	ccicchelli39@jiathis.com
caldhouse3a	fablott3a@who.int
lkuhle3b	esiddele3b@ifeng.com
jboulden3c	bgladdolph3c@forbes.com
backery3d	bspykins3d@mashable.com
rduigan3e	cshatliffe3e@bing.com
cbraidon3f	ebeller3f@friendfeed.com
cchina3g	adainton3g@free.fr
mmaseres3h	kesherwood3h@nature.com
whallatt3i	mcrooks3i@opera.com
rbartczak3j	cwhylie3j@geocities.jp
whousin3k	santrim3k@tmall.com
slegging3l	jfermoy3l@mac.com
cmarlin3m	fstetson3m@nature.com
mkimble3n	jgatlin3n@biblegateway.com
khellyer3o	adetheridge3o@wikia.com
kkellaway3p	fbernhardt3p@ezinearticles.com
adobrowolski3q	eguiduzzi3q@t.co
agras3r	bvereker3r@ox.ac.uk
gvanacci3s	areinhard3s@redcross.org
spobjay3t	cleaman3t@amazon.co.uk
pmallinson3u	lbumfrey3u@unblog.fr
gkiessel3v	cdollen3v@howstuffworks.com
ggoodwin3w	dpriestman3w@noaa.gov
lmcmillian3x	mmeece3x@loc.gov
jabrahmson3y	mdewi3y@surveymonkey.com
ybergin3z	ckenford3z@upenn.edu
rreims40	wdomini40@cam.ac.uk
tseccombe41	nryan41@craigslist.org
lfarady42	nmeak42@comsenz.com
ddudden43	hboatman43@zdnet.com
lbushnell44	lprofit44@opensource.org
flawrance45	aharriday45@paginegialle.it
fgreenleaf46	cwalker46@dailymotion.com
msabate47	rcalvard47@chronoengine.com
heglaise48	gkinnier48@sogou.com
cmaro49	mfowgies49@house.gov
tscotford4a	tsoars4a@creativecommons.org
asurcombe4b	bfernando4b@tiny.cc
cmayhow4c	tmaciunas4c@latimes.com
cdiggins4d	psemiras4d@prweb.com
mcaudelier4e	comar4e@shop-pro.jp
evanniekerk4f	cdunstall4f@barnesandnoble.com
cflewan4g	dmegroff4g@nhs.uk
twinckles4h	edalling4h@liveinternet.ru
vgouldstone4i	cluce4i@4shared.com
mmapplebeck4j	dthuillier4j@seesaa.net
rcripin4k	psowden4k@cmu.edu
ftremaine4l	mshayler4l@aboutads.info
gverlinde4m	pdalziel4m@tripod.com
msheehy4n	hhayer4n@ed.gov
derratt4o	bshilling4o@nih.gov
clansly4p	szanotti4p@g.co
mrosenblath4q	hkiddle4q@symantec.com
useson4r	hsier4r@artisteer.com
efleg4s	cexter4s@g.co
relvish4t	etudhope4t@accuweather.com
zbenedite4u	kbottoner4u@rambler.ru
janwell4v	tpiscopello4v@google.com
ikingman4w	fsadat4w@oracle.com
esergean4x	bgreschke4x@dedecms.com
lstoodley4y	cblankenship4y@google.com.hk
mraise4z	oconradsen4z@hao123.com
rbreede50	svasyatkin50@moonfruit.com
oeverard51	amacilhargy51@xrea.com
growbrey52	rroscrigg52@ucoz.ru
tsatford53	hmcdermot53@ucla.edu
efries54	bbuessen54@topsy.com
sneilus55	bmasse55@mediafire.com
awinchcomb56	cduerdin56@examiner.com
rhames57	wmeugens57@hhs.gov
cdislee58	mpoundford58@wikia.com
srenfield59	aworsom59@delicious.com
yperllman5a	umcmechan5a@redcross.org
fandrys5b	ayukhin5b@indiatimes.com
dmohun5c	wtrippitt5c@vkontakte.ru
bdowker5d	jgothup5d@newsvine.com
cdimitriev5e	tshernock5e@hugedomains.com
dearey5f	drainville5f@seesaa.net
bisaksen5g	icrampin5g@jiathis.com
strahmel5h	ragent5h@sun.com
ispellesy5i	uohenecan5i@themeforest.net
cmackriell5j	fsutcliffe5j@cdc.gov
rblackmoor5k	blyptratt5k@ebay.co.uk
wpickover5l	wrippingall5l@time.com
tofeeny5m	bianne5m@cisco.com
epeattie5n	mingledow5n@posterous.com
bguitonneau5o	ebowich5o@diigo.com
ebeggs5p	erosedale5p@free.fr
mthrossell5q	nsedgmond5q@tiny.cc
bsimonard5r	arizzone5r@dion.ne.jp
mlanaway5s	cwyrill5s@theatlantic.com
tmccaster5t	pacory5t@ifeng.com
bnisco5u	tmcauslene5u@mlb.com
esenechault5v	qpegden5v@boston.com
mbridgewood5w	ffishley5w@time.com
mklisch5x	opeerless5x@census.gov
dimlach5y	dprew5y@census.gov
epagen5z	cbrammer5z@state.gov
ecambridge60	jverbeke60@simplemachines.org
stranter61	acliss61@artisteer.com
skoch62	sberthot62@ca.gov
sgumby63	hyellop63@businesswire.com
chegges64	jidill64@bravesites.com
avise65	tcockling65@elpais.com
dpoag66	egreenman66@reuters.com
belkin67	rsevery67@jiathis.com
mmacdunleavy68	jsaltwell68@ihg.com
lglasscott69	gbirkmyre69@techcrunch.com
usteers6a	jdjorvic6a@ucsd.edu
gramel6b	kgallelli6b@lycos.com
tbundock6c	ckees6c@msu.edu
awaistell6d	gmycroft6d@ucsd.edu
rquick6e	iiacoboni6e@geocities.jp
otarbert6f	avasic6f@opensource.org
santonik6g	womulderrig6g@yellowbook.com
tnewis6h	ptapton6h@yellowbook.com
pheditch6i	lhailey6i@java.com
jpetegree6j	zhaton6j@instagram.com
thearty6k	rmelbury6k@amazon.com
glankester6l	ebradly6l@weather.com
bglasspool6m	mcopperwaite6m@columbia.edu
cgrigoryov6n	mgoude6n@redcross.org
wgontier6o	mshiels6o@addtoany.com
memmines6p	mdybell6p@cargocollective.com
khaggart6q	lkeers6q@fema.gov
nbonnesen6r	kbruffell6r@narod.ru
ebloxsom6s	ljepperson6s@ted.com
bkarpinski6t	ipaolo6t@icq.com
stolotti6u	kyepiskopov6u@behance.net
mcork6v	tskamal6v@creativecommons.org
thachard6w	rshevlane6w@technorati.com
nbenz6x	pneylan6x@ovh.net
fnewbury6y	gabelson6y@webnode.com
sgunda6z	pblackesland6z@tripadvisor.com
rneild70	dkeggins70@domainmarket.com
nstrodder71	dcossem71@yelp.com
bvize72	cmccoughan72@uiuc.edu
lpadginton73	bsandells73@alexa.com
wfabb74	acoiley74@prnewswire.com
eterbeck75	tdiprose75@nationalgeographic.com
dben76	rstaziker76@vistaprint.com
jbrookfield77	vnelm77@homestead.com
ohuskisson78	aphlipon78@hatena.ne.jp
tstickles79	rchamberlayne79@multiply.com
fsimnor7a	skroll7a@springer.com
rdenizet7b	bgarvill7b@flickr.com
drevett7c	ksellers7c@sciencedirect.com
rkryszkiecicz7d	wmclachlan7d@elegantthemes.com
ddrydale7e	ahail7e@biglobe.ne.jp
calbutt7f	emckeachie7f@gov.uk
agammade7g	kkennefick7g@sohu.com
bgianasi7h	kpude7h@va.gov
tderrett7i	eassaf7i@list-manage.com
bchiddy7j	gdemeyer7j@jugem.jp
ozink7k	kwastie7k@thetimes.co.uk
pspeachley7l	aharkin7l@skyrock.com
rkilvington7m	mpadula7m@youtube.com
odeverale7n	atheakston7n@auda.org.au
lmachent7o	khoyes7o@naver.com
jkelsow7p	wwillshire7p@ow.ly
cmenary7q	afansy7q@timesonline.co.uk
jebanks7r	mgaraway7r@washington.edu
rolenchikov7s	rnancarrow7s@nasa.gov
mmackall7t	jgumbrell7t@oaic.gov.au
mfulep7u	nparlott7u@godaddy.com
tblagburn7v	bisley7v@alexa.com
srobottom7w	lwatsonbrown7w@hugedomains.com
egawke7x	ravory7x@quantcast.com
nbrockie7y	bsedwick7y@angelfire.com
smonini7z	gazemar7z@ucla.edu
hhonisch80	ejerred80@xrea.com
sliptrod81	bprovest81@myspace.com
lerington82	whatliff82@pcworld.com
plilburne83	kbish83@imgur.com
kcortnay84	iknightly84@illinois.edu
ctyre85	ldeackes85@nationalgeographic.com
lhendron86	chamshar86@businesswire.com
cwyard87	hknowlton87@google.nl
kmusson88	mjager88@nhs.uk
ihinken89	achevalier89@smh.com.au
sdow8a	aseddon8a@exblog.jp
wverheijden8b	mclapham8b@list-manage.com
totley8c	ebeevis8c@usa.gov
hchecchetelli8d	gquail8d@sina.com.cn
abourget8e	bthorrington8e@google.com.hk
sjosefovic8f	mcoultard8f@diigo.com
tamsden8g	soxbury8g@elegantthemes.com
hmarmon8h	chember8h@nymag.com
mtuiller8i	fmunkley8i@bizjournals.com
cwigsell8j	nballham8j@xing.com
bofallon8k	hgladstone8k@yale.edu
mmccaffrey8l	mgawen8l@accuweather.com
hpanswick8m	mstorcke8m@usnews.com
vbasten8n	gszimoni8n@netlog.com
gbinder8o	aarundel8o@independent.co.uk
emaskell8p	hphelp8p@oakley.com
vchessell8q	vchanson8q@businessinsider.com
tvitler8r	ncotman8r@aboutads.info
sbillings8s	rbateson8s@cbslocal.com
bburel8t	amattiassi8t@arizona.edu
stegler8u	bhaburne8u@chronoengine.com
baynscombe8v	ocrampton8v@list-manage.com
breily8w	mciobotaro8w@msu.edu
tocuddie8x	bcanti8x@reuters.com
bdoyley8y	mscanderet8y@jigsy.com
rarnau8z	hmusson8z@yahoo.com
mayce90	ecornforth90@army.mil
ebiers91	szannelli91@google.es
ajosephsen92	apoyner92@microsoft.com
rswift93	hbootton93@redcross.org
scrole94	kbattams94@yelp.com
btwelve95	dsprackling95@netlog.com
obainbrigge96	cgodbold96@google.cn
gharmson97	cdillow97@4shared.com
cagett98	hfinkle98@hatena.ne.jp
lmourton99	hbelfit99@mac.com
alewis9a	skalisz9a@hc360.com
mcona9b	hmcquaide9b@ucla.edu
tstarkey9c	umizen9c@artisteer.com
tjeyes9d	ehallen9d@patch.com
mbrickstock9e	cpergens9e@over-blog.com
clinklater9f	ilarne9f@weebly.com
jloraine9g	vgumm9g@businesswire.com
amckleod9h	asoigne9h@amazon.de
hgosson9i	aginnelly9i@webnode.com
mgoodwins9j	mfooter9j@storify.com
fabilowitz9k	adirand9k@unesco.org
sfish9l	twhyffen9l@blogs.com
hbrizell9m	lfaley9m@1688.com
mskyner9n	nboutellier9n@live.com
jsimco9o	rflori9o@adobe.com
padicot9p	shaugh9p@shop-pro.jp
epoxson9q	wromaine9q@marketwatch.com
cmellhuish9r	mivashkov9r@technorati.com
lguiduzzi9s	droggieri9s@joomla.org
shoopper9t	saxton9t@buzzfeed.com
vmorby9u	mmcbratney9u@eepurl.com
amonck9v	msager9v@unicef.org
cgoalley9w	nmasse9w@instagram.com
jrobbeke9x	froebuck9x@netlog.com
csimoneau9y	mzohrer9y@youtu.be
htwelvetree9z	gwoolager9z@webmd.com
cpartona0	braishera0@mapquest.com
uboleyna1	kpicktona1@independent.co.uk
sdilgarnoa2	edrakesa2@tiny.cc
sshakesbyea3	afernehougha3@amazon.co.uk
hcowlesa4	jtravisa4@webnode.com
gspeddinga5	rskerritta5@ibm.com
sceschinia6	bdawida6@miitbeian.gov.cn
pkingerbya7	mmcgroartya7@prnewswire.com
aelverstonea8	jwormalda8@umn.edu
oaughtona9	twindousa9@epa.gov
rwarkupaa	jmuxworthyaa@cnbc.com
mbromigeab	wmullerab@usgs.gov
nboydleac	mperrinchiefac@samsung.com
tgrittenad	iblantad@nature.com
amittenae	nchataignierae@microsoft.com
asyredaf	khellmeraf@house.gov
kaudusag	rboorerag@deviantart.com
dvarianah	hgirdwoodah@example.com
dpolsonai	tkannai@google.it
kswainstonaj	plantaphaj@amazon.com
oilbertak	vshortallak@blogger.com
vhamelynal	ksandysal@salon.com
brasoram	ivinnickam@unesco.org
jshasnanan	lratchfordan@scribd.com
awilkissonao	spresslandao@skype.com
dbehlingap	lpyserap@cornell.edu
erozzieraq	igosnollaq@merriam-webster.com
rmizziar	alutwychear@cafepress.com
kgawithas	rpettyfaras@lycos.com
onoweakat	qcicchettoat@chronoengine.com
rrohlfingau	jkoppensau@marriott.com
bpassbyav	tdavidsenav@abc.net.au
meyckelaw	msmitherhamaw@amazonaws.com
rperoax	mnaisbetax@1und1.de
vgutchay	nstclairay@smugmug.com
plosekeaz	kblazicaz@discuz.net
wsellimanb0	vtaitb0@nhs.uk
pbattamsb1	kmonnellyb1@wikimedia.org
rhazeupb2	crottgerb2@theguardian.com
gmutimerb3	eloghanb3@dropbox.com
wjouandetb4	dmartinellob4@archive.org
ghuggonsb5	jsharvilleb5@sitemeter.com
bchanterb6	pbernhardssonb6@51.la
gjohananoffb7	omanthab7@hubpages.com
smaccarterb8	zkrzyzowskib8@google.com
aenrigob9	aheinekingb9@google.es
hadamczykba	kdawkesba@intel.com
eputtanbb	elynaghbb@nyu.edu
whammerstonebc	rhowkinsbc@oakley.com
rpinkertonbd	ulipsonbd@about.me
cbogbe	kbowebe@123-reg.co.uk
inoahbf	dblankobf@fotki.com
hkaradzasbg	sgendrichbg@purevolume.com
bbenyanbh	lkenyambh@netvibes.com
cbruinsbi	nantoszczykbi@rediff.com
olavrickbj	battonbj@biblegateway.com
jsaurabk	nansteebk@mlb.com
bthompstonebl	mchattenbl@flavors.me
pandrejsbm	sgregersenbm@patch.com
prafebn	mfaierbn@ow.ly
btwiggbo	ayesipovbo@reuters.com
pnorthedgebp	mserjeantbp@opera.com
lgrinyerbq	cmeatcherbq@twitpic.com
emiddellbr	kduffriebr@aboutads.info
iorrickbs	ncappsbs@google.de
kbrettonbt	mslatefordbt@amazon.com
gaxtonnebu	rskotcherbu@vimeo.com
rpeggbv	oicetonbv@wix.com
mpinabw	dmarietbw@altervista.org
acoxheadbx	kpohlkebx@jimdo.com
mswainstonby	emogeyby@pbs.org
abrockiebz	apavlikbz@gravatar.com
ngarforthc0	mwillshearc0@oakley.com
eshaughnessyc1	ahirjakc1@examiner.com
salthorpec2	gbabbec2@fastcompany.com
wgaskillc3	cvincentc3@spotify.com
wmesantc4	tlillicropc4@sakura.ne.jp
lkarchowskic5	kzellandc5@yolasite.com
agilleanc6	dtippellc6@wisc.edu
hpullmanc7	vdenersc7@zimbio.com
mgallearc8	cdivec8@pagesperso-orange.fr
yjerzykiewiczc9	jliggensc9@facebook.com
mheggisonca	rdowningca@pcworld.com
ghawkyenscb	tdanilincb@miitbeian.gov.cn
hnutbeemcc	ttremoillecc@wikispaces.com
hgiovannaccicd	mmcelrathcd@mysql.com
clearyce	lmiramsce@oracle.com
clearoidcf	ccatorcf@amazon.co.jp
girniscg	tbenechcg@theatlantic.com
lsabinch	adanzelmanch@vinaora.com
evanaccici	agoodersonci@instagram.com
gsiudacj	dcootcj@blogger.com
esurteesck	lboyetck@friendfeed.com
mmchirriecl	ekinghorncl@cocolog-nifty.com
awillancm	bbeggancm@elegantthemes.com
oashwoodcn	dklinercn@nytimes.com
akohnco	esnalumco@delicious.com
csapeycp	itappingtoncp@ow.ly
jsargeantcq	doscanloncq@wordpress.com
bstrettlecr	jcorzorcr@altervista.org
rsibillecs	ebamseycs@shutterfly.com
adeverillect	yhodintonct@narod.ru
rculloncu	everlindencu@virginia.edu
lsmissencv	alebboncv@economist.com
rgarfieldcw	kamoricw@scribd.com
dmeriguetcx	ngillivercx@cbc.ca
fnorcopcy	wcragoecy@forbes.com
severshedcz	nfortyecz@nba.com
gcabbelld0	jjoisced0@forbes.com
mpetrashkovd1	anazaretd1@desdev.cn
mpemberd2	ncalytond2@tripadvisor.com
lmcbryded3	wspellard3@mit.edu
mchristophersend4	acracknelld4@independent.co.uk
cbrinsdend5	dfeavearyeard5@bravesites.com
lmollettd6	bfeathersbyd6@creativecommons.org
czuted7	kbriffettd7@ovh.net
dseawelld8	idockreed8@artisteer.com
msergisond9	urosbottomd9@state.gov
ckemmeda	igommda@guardian.co.uk
hhuftondb	vswyndleydb@mysql.com
flambelldc	dconquerdc@uol.com.br
lsprakedd	jselburndd@nationalgeographic.com
tdrancede	arudolfde@rediff.com
npaulssondf	mtaleworthdf@acquirethisname.com
sliddondg	slivingstondg@elpais.com
mwadleydh	rdrewcliftondh@imgur.com
ccauntdi	rlukianovichdi@people.com.cn
dfattorinidj	cpratordj@whitehouse.gov
achartdk	mvolkesdk@usatoday.com
agorriedl	sastleydl@opera.com
apaulettidm	souterbridgedm@craigslist.org
cdellenbrokdn	nlombarddn@mapy.cz
cpassinghamdo	amuspratdo@bizjournals.com
cswalesdp	hbritneydp@bizjournals.com
mhagstonedq	acatherickdq@uiuc.edu
edoumerdr	ajackdr@vinaora.com
kcuttends	mportrissds@spiegel.de
wbarnevilledt	fbrydiedt@qq.com
vpankhurstdu	rsainterdu@discovery.com
atrustiedv	mmanilovedv@admin.ch
lshieberdw	fschonfelderdw@ca.gov
cchoakedx	mvokesdx@google.co.uk
kliddiattdy	mpockeydy@nba.com
bmccambridgedz	bdyetdz@cbslocal.com
tbirdwhistlee0	sstarte0@elegantthemes.com
lgrcice1	tsmalinge1@goo.ne.jp
acordinglye2	bpearmane2@deliciousdays.com
agerardete3	acottye3@slate.com
vcritzene4	mscoltse4@t-online.de
waronovitze5	kdaintreee5@wp.com
hbonteine6	gkirkmane6@github.com
tammere7	nnibloee7@t-online.de
nbenchere8	ckieranse8@google.ru
rmccromleye9	mbavestere9@mayoclinic.com
brosenhauptea	jkeesea@toplist.cz
tstiveyeb	asouthwortheb@un.org
kstonefewingsec	phillettec@moonfruit.com
lfendered	rvaudreed@time.com
mwillcoxee	lbogeysee@wisc.edu
dblamiresef	sbranchetef@cnbc.com
famiseg	fsummersideeg@ox.ac.uk
gbroschkeeh	dbeernaerteh@cafepress.com
magiolfingerei	mcalrowei@sourceforge.net
gcarlssonej	vbrezlawej@zimbio.com
lhayfieldek	lpakemanek@51.la
carbuckleel	jmicklewiczel@goo.ne.jp
wjanceyem	mglascottem@cam.ac.uk
cmccaughenen	kswinnarden@webmd.com
nmelberteo	bmellereo@ftc.gov
gdrainep	ascurryep@wisc.edu
nheldereq	vmatteseq@nih.gov
ahyronser	lcurrer@slideshare.net
jportales	tswiggeres@google.com.br
rgriefet	ecastelloneet@icq.com
gstuchberyeu	ebidewelleu@reuters.com
sclohiseyev	tmccrieev@home.pl
ndrewsew	hgilffillandew@nydailynews.com
acapstackex	rpyottex@timesonline.co.uk
bmoizerey	pdrageey@icq.com
hstrobandez	ktempletonez@creativecommons.org
hsainesf0	rcrellinf0@newsvine.com
tbegentf1	vortzenf1@dmoz.org
dmahadyf2	neverexf2@histats.com
nlozanof3	ghazeldinef3@stumbleupon.com
glamartinef4	grubinf4@answers.com
lmoldf5	canyenef5@freewebs.com
lbeeswingf6	lgodarf6@blog.com
gbauducciof7	iprittyf7@wiley.com
bhambrickf8	rsibyllinaf8@dagondesign.com
chaneyf9	cprozillof9@techcrunch.com
mpetrusfa	kravenfa@dedecms.com
nnapletonfb	wlethburyfb@flickr.com
lmagnefc	gstrondfc@parallels.com
gorrettfd	ckoppsfd@un.org
mibelfe	ajeckellsfe@scribd.com
fwiddisonff	jglovesff@usgs.gov
wcarillofg	mbatrimfg@cdbaby.com
dspringerfh	dwrassellfh@goo.gl
ngoodludfi	sreadfi@dedecms.com
hlomathfj	mgeavesfj@vistaprint.com
rhandlingfk	cbiggsfk@canalblog.com
gmcgrathfl	rdunyfl@infoseek.co.jp
abaudetfm	nmandryfm@nytimes.com
aedmundsfn	saberkirdofn@statcounter.com
wbirchenoughfo	rsandesonfo@sciencedaily.com
macuttfp	nstattonfp@cnn.com
lcoolahanfq	alabastidafq@skyrock.com
lspohrmannfr	craynorfr@facebook.com
malpfs	zriddochfs@ask.com
mmallowsft	fshreveft@posterous.com
rmcowisfu	zgerdesfu@bigcartel.com
pcastagnerifv	mgaufordfv@wikia.com
nbradforthfw	ldunnawayfw@sina.com.cn
bmasicfx	fmaseyfx@dagondesign.com
ylangstrathfy	nfeavearyearfy@china.com.cn
adevofz	bbaskeyfieldfz@marketwatch.com
ebesteg0	wsimionescug0@un.org
cdrynang1	hgodong1@geocities.jp
wapplegateg2	ichueg2@wsj.com
rmaywardg3	ahastingsg3@sogou.com
sshrigleyg4	gaudusg4@java.com
nkirsoppg5	akelsong5@issuu.com
egodierg6	smaclureg6@seesaa.net
telsmereg7	modriscollg7@yandex.ru
rchavring8	atrulockeg8@people.com.cn
omoscog9	fthorneleyg9@indiegogo.com
amixerga	mmcleesega@dell.com
rmarquetgb	kmullingergb@tmall.com
wwilkennsongc	flovelgc@odnoklassniki.ru
bchantrellgd	mwynrahamegd@blog.com
bdroverge	vlantuffge@bing.com
smeineckgf	ntiptaftgf@cmu.edu
ekleinegg	sbrynsgg@4shared.com
tmedewaygh	nbarnettgh@walmart.com
sstartegi	aflintoffegi@usa.gov
khaimesgj	rglengj@indiegogo.com
vandreolettigk	kferreogk@wordpress.org
cmactrustygl	csteelsgl@google.cn
lgarwillgm	rwildgoosegm@prweb.com
dfeldmarkgn	edumelowgn@desdev.cn
pithellgo	obowtongo@g.co
npettegreegp	mpinkegp@walmart.com
caustwickgq	ebednellgq@360.cn
lgotecliffegr	ythomassengr@dailymail.co.uk
pofarrisgs	fdysongs@com.com
escaplehorngt	koffellgt@technorati.com
ldrewsgu	lsweatmangu@youku.com
dfairngv	iwarrickergv@devhub.com
nbuttsgw	gbockmangw@mac.com
rmcadamgx	mmatisoffgx@bluehost.com
mlepoidevingy	rorielgy@patch.com
rnorvalgz	mevettgz@utexas.edu
fmcsparranh0	cemanuelovh0@geocities.jp
jfeldsternh1	gcunniamh1@ifeng.com
spiburnh2	eblodgetth2@jalbum.net
oconniamh3	dkarpychevh3@linkedin.com
gdurbinh4	aropeh4@epa.gov
htrahairh5	dianielloh5@sourceforge.net
vcrooth6	lnanellih6@geocities.com
oslymeh7	nsebringh7@cnbc.com
batheyh8	cthompsonh8@elegantthemes.com
jgilstinh9	bsnawdonh9@thetimes.co.uk
awalasikha	esennettha@jalbum.net
cyakolevhb	gboxillhb@github.com
tsedgehc	fpallatinahc@google.ca
jarpinhd	npassiehd@hexun.com
cspraberryhe	jdakinhe@va.gov
cgreschikhf	sgiacobbinijacobhf@alibaba.com
mparnbyhg	rmckmurriehg@marriott.com
fbaudouhh	rjinkshh@goo.gl
seckhhi	kkantorhi@symantec.com
fhawsonhj	hanettshj@amazonaws.com
britchardhk	dstanlockhk@homestead.com
ghabornhl	ralesohl@cisco.com
ibythwayhm	kspiviehm@barnesandnoble.com
tfarnorthhn	rcaddiehn@omniture.com
bbringloeho	fdeeproseho@opera.com
eknottonhp	vkidmanhp@nhs.uk
sbuglerhq	jradsdalehq@artisteer.com
rnicelyhr	gstackbridgehr@g.co
drobbeyhs	tmorenahs@ow.ly
vivanetsht	cmatusovht@hud.gov
gmagennyhu	rcleynmanhu@tmall.com
hneeveshv	gbraundhv@i2i.jp
lbartoszekhw	jlatorrehw@wikia.com
dwolversonhx	plangeleyhx@tuttocitta.it
fborgesiohy	rcolthursthy@twitter.com
ngelderhz	lmacanehz@amazon.co.jp
amurtoni0	adriolii0@dyndns.org
jlascelli1	dvynalli1@businesswire.com
bbartalettii2	meaglestoni2@prnewswire.com
lbestimani3	cnicholsoni3@youtube.com
dkimblyi4	rbechei4@blogger.com
hrippingi5	lsempilli5@t-online.de
abiaginii6	nennewi6@ustream.tv
sbellwoodi7	igarcesi7@fda.gov
pheinsiusi8	ckyteleyi8@bloglovin.com
gmessieri9	lgiffordi9@weather.com
awetternia	jdaxia@yelp.com
ihiomib	kyukhnovib@irs.gov
adonisiic	fkitchinghamic@opera.com
lcaultonid	jgauntlettid@java.com
dlauthianie	ghamlettie@studiopress.com
abartoschif	ttolchardif@barnesandnoble.com
cbalassaig	rallowayig@un.org
bjentgesih	sbaronih@lulu.com
bduffrieii	ttumiotoii@arizona.edu
bdemkeij	igallearij@nhs.uk
mspainik	ldoik@studiopress.com
jflowerdenil	gtwizellil@eventbrite.com
fspellwardim	eseivertsenim@infoseek.co.jp
ccrevaghin	rbernardezin@independent.co.uk
lschurigio	lnapoliio@abc.net.au
areedieip	cdenesip@xrea.com
aheatleyiq	cfrowdeiq@tumblr.com
tcastaneir	oaskerir@csmonitor.com
erodgeis	hgasnollis@nhs.uk
cbradnockeit	jfrancilloit@chronoengine.com
pcalliu	lherrerosiu@loc.gov
dzmitrichenkoiv	ltarbiniv@samsung.com
rmassimoiw	hrettieiw@ovh.net
cverdeyix	mmollettix@chron.com
sdykaiy	kpurdoniy@netlog.com
fshowleriz	hlateyiz@studiopress.com
tmardlej0	jbrinsonj0@mozilla.org
tspenslyj1	kgeakej1@toplist.cz
jwoolleyj2	rmaherj2@plala.or.jp
aberzenj3	flambrookj3@nba.com
sgierhardj4	kherrerosj4@tiny.cc
bspridgenj5	sdewittj5@businessweek.com
adowningj6	rrougierj6@wikimedia.org
ashowellj7	khowchinj7@topsy.com
ejohnceyj8	vandrinij8@pcworld.com
hmeasj9	tosmentj9@microsoft.com
catterburyja	icotonja@yahoo.co.jp
dlibbiejb	cvasejb@foxnews.com
smacshanejc	wstadingjc@alibaba.com
cbleierjd	jcostellowjd@t-online.de
smcgraeje	amcneilje@ftc.gov
asaladinojf	rnaptonjf@cdc.gov
eneggrinijg	kgassonjg@reference.com
jfrancjh	lsibrayjh@wikispaces.com
earnaudinji	mfisbeyji@technorati.com
elacroutzjj	gtriggsjj@tripod.com
isteptoejk	kdunseathjk@google.cn
achasierjl	skitneyjl@wunderground.com
emartinejm	tspeddinjm@shinystat.com
jespinosajn	jpattleljn@admin.ch
dpeckittjo	mingoldjo@utexas.edu
nfirbankjp	nbarliejp@fastcompany.com
cclooneyjq	sharwelljq@soundcloud.com
wmottershawjr	czimmermeisterjr@nhs.uk
ksummerleyjs	gdavidovicijs@vinaora.com
fberreyjt	cgottsjt@howstuffworks.com
dmcquodeju	wmathouseju@addtoany.com
rprimojv	mtappinjv@state.tx.us
aabramowitchjw	krumseyjw@boston.com
mdorkenjx	agodlipjx@yahoo.co.jp
garckolljy	kselesnickjy@census.gov
vgetshamjz	tlimbrickjz@illinois.edu
gyokleyk0	rwhitlamk0@marriott.com
epinwillk1	mdainesk1@fotki.com
dvasick2	pgullivank2@ebay.co.uk
osymmersk3	hvanhovek3@admin.ch
nbetteridgek4	dchedgeyk4@mail.ru
agrigorkink5	bbuckwellk5@ask.com
bfairholmek6	cdominichellik6@statcounter.com
jparkmank7	dfawcettk7@usa.gov
moaksk8	rdodgek8@infoseek.co.jp
crenoufk9	lregisk9@google.com.au
lgatchelka	kwinceka@timesonline.co.uk
tchadwinkb	alittlepagekb@ed.gov
tpickeringkc	mlangekc@bluehost.com
tgettingskd	lgoodmankd@archive.org
gstuckowke	mwhilderke@sakura.ne.jp
lmaddickkf	fwildingkf@businesswire.com
mwhilderkg	thassurkg@discuz.net
tmitiekh	agouldbournkh@wordpress.org
gseyski	ldebullionki@fc2.com
kgrzelczykkj	spheaseykj@oakley.com
rfaucherandkk	kpawlickikk@sohu.com
nmerlinkl	ccastagnekl@artisteer.com
hrodiekm	kchaterkm@woothemes.com
hhuskkn	cbaszkiewiczkn@tumblr.com
ncruikshanksko	cdowthwaiteko@ox.ac.uk
dmcmorrankp	mechalliekp@prnewswire.com
mbywaterkq	aandersenkq@arstechnica.com
mfenlonkr	aphittiplacekr@pcworld.com
csmeetonks	tpollardks@jugem.jp
pemmisonkt	deagletonkt@buzzfeed.com
ascafeku	bpikenku@canalblog.com
mratleekv	gcakekv@home.pl
frichardsonkw	mveljeskw@narod.ru
arhoddiekx	cdennerleykx@gmpg.org
lpattrickky	aeastbyky@shareasale.com
smalonekz	pdulykz@dmoz.org
rgoncavesl0	lfrancecionel0@jigsy.com
rlebarreel1	adoncasterl1@hc360.com
pstanlockl2	srippenl2@e-recht24.de
mloxleyl3	dryalll3@google.de
dlangrickl4	jwoolensl4@zdnet.com
dadawayl5	clumsdainel5@google.it
lgainsefordl6	stucselll6@addtoany.com
aascraftl7	lranyelll7@addtoany.com
dhatcliffel8	beilersl8@usatoday.com
lhollingsbeel9	beckersalll9@buzzfeed.com
kdixla	iheustacela@state.tx.us
cbarneslb	pgiraudatlb@wp.com
lbrixeylc	hberingerlc@xrea.com
gkilbyld	rpeirceld@ask.com
mcysterle	awelbrockle@wp.com
gdawleylf	ikyberdlf@squidoo.com
jreinertlg	tcristofanolg@unesco.org
wkenracklh	mgleaderlh@theglobeandmail.com
sfahyli	aborastonli@devhub.com
awilkisonlj	graubenheimerlj@php.net
bhaggarlk	bedworthylk@sun.com
ktolchardll	mishchenkoll@parallels.com
hcarrabotlm	rcorradeschilm@infoseek.co.jp
cpedroniln	ncruseln@hostgator.com
lperselo	ggoncalolo@facebook.com
flawlesslp	rhurichelp@wired.com
vwhykelq	dklassmannlq@soundcloud.com
cdorneylr	psentlr@skype.com
jgawthorpels	cshalesls@microsoft.com
dlarcombelt	emacarthurlt@rediff.com
tjacobsohnlu	cguntherlu@jimdo.com
gdavillelv	pcullneanlv@aol.com
frabbagelw	kmuckartlw@newsvine.com
mnancelx	bjobsonlx@geocities.jp
amacnessly	ssowterly@google.com
pchomickilz	apiscolz@go.com
bshermarm0	spicfordm0@wikia.com
cganningm1	etickelm1@chicagotribune.com
woldfieldcherrym2	dhardagem2@blogs.com
estegglesm3	echilesm3@soup.io
mwarrenerm4	zgoodlattm4@unesco.org
rtinnm5	rknotonm5@example.com
adalglieshm6	mphilipssonm6@wix.com
wmaudlinm7	mcarmem7@e-recht24.de
skimmonsm8	cgounym8@google.ca
tgouinlockm9	kgisbornem9@domainmarket.com
gbennionma	jdominguezma@surveymonkey.com
chayfieldmb	rscarsbrickmb@symantec.com
lternmc	kdavidofmc@whitehouse.gov
eduddellmd	amirfieldmd@prnewswire.com
lakessme	kfanceme@addthis.com
rcarssmf	vheddenmf@myspace.com
amaddisonmg	rguppeymg@goodreads.com
tcaldronmh	fcockellmh@senate.gov
cmcveighmi	hstilemi@vinaora.com
tithellmj	wcolquytemj@deliciousdays.com
sisgatemk	ckillerbymk@japanpost.jp
rcohenml	ngerishml@com.com
ghaythornthwaitemm	cbernmm@businesswire.com
crohlfingmn	udunckleemn@reuters.com
ltopingmo	zmallinsonmo@slideshare.net
hgrevesonmp	tlumbleymp@ow.ly
wdannellmq	dvobesmq@sciencedirect.com
ccopynmr	esebertmr@instagram.com
cchritchlowms	arobberechtms@businessinsider.com
corhrtmt	mstillwellmt@msn.com
cgowlettmu	eblythmu@reverbnation.com
gjohnseymv	pdematteimv@phpbb.com
ssteensonmw	rkeddiemw@mlb.com
gsiselandmx	tbarrowcloughmx@seesaa.net
ahamshermy	vsangarmy@free.fr
tharnesmz	sbockingmz@mtv.com
sfouldesn0	yspringern0@ucla.edu
athomtsonn1	scawkern1@artisteer.com
fjohnseen2	jfourcaden2@gizmodo.com
ibellangern3	kmantn3@friendfeed.com
kbaldersonn4	astoakesn4@elpais.com
aosmentn5	akristoffersenn5@mapy.cz
rdocketn6	rblaxalln6@salon.com
gstricklandn7	jsimakovn7@skyrock.com
skahenn8	fchesen8@newyorker.com
lshevlann9	mheaslyn9@ftc.gov
bseresna	lbomanna@epa.gov
ewillgossnb	gbagnallnb@furl.net
fcowillnc	ctudballnc@hhs.gov
tkattenhornnd	osommerlednd@wisc.edu
ckrikorianne	ggroomene@sbwire.com
dlopeznf	vchestnutnf@telegraph.co.uk
zikinsng	ibrancheng@guardian.co.uk
dtukenh	strowbridgenh@google.it
cdodswellni	scluesni@ftc.gov
cgerckensnj	abernardeschinj@narod.ru
hbrindnk	cgammillnk@wsj.com
agogertynl	khaversumnl@rambler.ru
vaylesburynm	mrichardssonnm@blogs.com
vcrollmannn	kbarfordnn@forbes.com
ddoberno	jeddowisno@ovh.net
mgormannp	uspreadnp@flickr.com
kthroughtonnq	brobbienq@live.com
lmcpakenr	shallernr@comsenz.com
ofonteynens	yphilippartns@shutterfly.com
lmidsonnt	cokellynt@blogtalkradio.com
ahulettnu	ademkowicznu@webs.com
gduffilnv	jwalickinv@naver.com
bbroughamnw	dcrappernw@mozilla.com
hbohlernx	wlorenzettinx@theatlantic.com
vkybirdny	lhitzmannny@amazon.com
aselwynenz	hcraigienz@engadget.com
lfaulkeso0	gemslieo0@china.com.cn
crallingo1	psomertono1@netlog.com
mkuhnelo2	ffelipo2@mysql.com
cgiraudeauo3	hjozwickio3@engadget.com
rvonhagto4	acockleyo4@fc2.com
fgiacomio5	glamorto5@senate.gov
agilkeso6	gflounderso6@wordpress.org
fforcadeo7	sstanlicko7@simplemachines.org
dbenedicto8	thumeo8@msu.edu
lbastowo9	fbeyno9@jiathis.com
llaceoa	alamingoa@bing.com
sbickerstethob	aeubankob@msn.com
psharkeyoc	mdorranceoc@yale.edu
dbramwichod	uabbyssod@issuu.com
ddeaneoe	awinnisteroe@people.com.cn
uparlotof	adoelof@seattletimes.com
kdoegog	dbenesevichog@symantec.com
bpovalloh	toguzoh@acquirethisname.com
kgernieroi	kjeromsonoi@newsvine.com
abloseoj	shaleoj@foxnews.com
nstreetleyok	vmardeok@apple.com
rnuddol	pobradaneol@sciencedirect.com
gdequinceyom	aspreckleyom@thetimes.co.uk
tfluinon	nstanbroon@edublogs.org
fcarneckoo	pbonifaceoo@sbwire.com
ljoscelyneop	lrobothamop@cdc.gov
grosomanoq	bmarriottoq@linkedin.com
hessameor	abeldonor@hud.gov
ggianullios	eslatfordos@dmoz.org
kcharteot	ppetowot@cbc.ca
dbonifazioou	bviscoviou@howstuffworks.com
rochiltreeov	kgilstinov@sbwire.com
jhugliow	rnezeyow@csmonitor.com
rtookerox	ecawdronox@wordpress.org
ldanaheroy	cloddyoy@macromedia.com
tgunnoz	dbroughoz@google.com.hk
spechardp0	rszymonip0@twitter.com
jaseefp1	dbraidenp1@rakuten.co.jp
vmcelweep2	awesternp2@smh.com.au
trobotthamp3	akilmurrayp3@wisc.edu
tmonganp4	atomap4@123-reg.co.uk
lvaneevp5	shousecroftp5@mtv.com
smckallp6	smackailep6@hp.com
krippingallp7	jgorryp7@thetimes.co.uk
lkernellp8	mrewanp8@shinystat.com
istrikep9	gwaslinp9@unc.edu
trollerpa	rpurkesspa@craigslist.org
aroafpb	bbothenpb@cocolog-nifty.com
srussampc	hminotpc@rediff.com
flochpd	afeatenbypd@gravatar.com
mbestarpe	kwolversonpe@tinypic.com
bplompf	handriessepf@issuu.com
mmuckartpg	lmaywoodpg@samsung.com
lstrotonph	pbrealeyph@myspace.com
aaudisspi	lgracepi@bizjournals.com
abrixeypj	cboddpj@tripadvisor.com
chuardpk	coakenfieldpk@netscape.com
fseamarkepl	ccockshttpl@soundcloud.com
kmumfordpm	pdaglishpm@europa.eu
mallinsonpn	gmorricepn@chronoengine.com
gsimmenspo	sguthriepo@list-manage.com
mradloffpp	dnayshepp@bluehost.com
dscogganspq	gpenkepq@sourceforge.net
cavrashinpr	nregardsoepr@digg.com
dcaunterps	agoldspinkps@google.es
cburchfieldpt	vpedlinghampt@twitpic.com
oosannepu	mdatonpu@craigslist.org
carnaldpv	sarghentpv@usda.gov
sjervoispw	egoodsellpw@ebay.co.uk
rmckinnonpx	eschubuserpx@cmu.edu
mbarteletpy	skennfordpy@cafepress.com
jcroninpz	lharfootpz@wunderground.com
wempletonq0	cadamkiewiczq0@wired.com
djozefowiczq1	ghodginq1@mtv.com
bkeableq2	hboldenq2@senate.gov
hluetkemeyerq3	bferroliq3@soundcloud.com
otetlowq4	colagenq4@washingtonpost.com
jjackettsq5	sbawleq5@cdbaby.com
mgreasonq6	bcaddellq6@addtoany.com
amaldenq7	kcyplerq7@posterous.com
klowndsq8	wclimpsonq8@cornell.edu
awissonq9	liannoq9@a8.net
edenzilowqa	rrosenwasserqa@myspace.com
adurningqb	rherreranqb@rambler.ru
simesonqc	nouldcottqc@upenn.edu
nherreroqd	gcalleryqd@howstuffworks.com
mbridgwaterqe	rcalcuttqe@discuz.net
fpierrepontqf	ahamsharqf@census.gov
vhaylesqg	nreelyqg@addtoany.com
dholahqh	miacovazziqh@360.cn
abilverstoneqi	sisacqi@pagesperso-orange.fr
rdemeqj	eheinritzqj@ca.gov
fkirmanqk	mwhybornqk@telegraph.co.uk
lranaldql	fklezmskiql@globo.com
cbartlomieczakqm	sstranieriqm@ovh.net
zmateosqn	kcamiesqn@cam.ac.uk
wfittqo	adabbsqo@hostgator.com
lbanfieldqp	crubbertqp@livejournal.com
mlakinqq	dputtrellqq@pinterest.com
sjestecoqr	gbartunekqr@friendfeed.com
dwildorqs	btwitteyqs@jimdo.com
cmuehlerqt	pcrightenqt@dedecms.com
creavellqu	rbogacequ@homestead.com
jtethcoteqv	pfeeqv@freewebs.com
ecalbratheqw	pwicklingqw@newsvine.com
mduerqx	jtominiqx@liveinternet.ru
mgentzschqy	nfairheadqy@xing.com
wbrophyqz	woddqz@cyberchimps.com
cnannr0	dbenittir0@4shared.com
oclimor1	ppantecostr1@sina.com.cn
jmacleser2	tdallanr2@newsvine.com
rateggartr3	cmuckler3@jugem.jp
aroderr4	kmcgraffinr4@cbc.ca
jstuchberyr5	amatzker5@ow.ly
nlallyr6	lmccartneyr6@constantcontact.com
zravenshawr7	snussenr7@businessweek.com
aoffar8	fgawkesr8@wp.com
vrotger9	ngollopr9@upenn.edu
cjakoubra	bbamlettra@hatena.ne.jp
kgawenrb	rwoolaghanrb@skype.com
hsilkrc	mpomeryrc@themeforest.net
dcoultousrd	gcorleyrd@youtube.com
jlettingtonre	lsmorthitre@house.gov
mhaggidonrf	uperrittrf@hibu.com
zpetrulisrg	nhourahanrg@soundcloud.com
swankelrh	gcummingsrh@pagesperso-orange.fr
jbransdonri	gloosri@nsw.gov.au
jlippiettrj	rmckinlessrj@imgur.com
jgerrardrk	cmillardrk@moonfruit.com
ronslowrl	mjanousekrl@gnu.org
ghynesrm	wolagenrm@nydailynews.com
nugorn	wmartinellorn@nydailynews.com
bpeperellro	vbeamsonro@dot.gov
tbewshawrp	rneaglerp@blogtalkradio.com
rescalanterq	pcranerq@princeton.edu
dtottonrr	asinkinrr@house.gov
